AAAAATTTTTTTTTTTTTTTTTTAA
AAAAATTTTTAAAAAATTTTTTTAA
AAAAATTTTTAAAAAATTTTTTTAA
AAAAATTTTTAAAAAATTTTTTTAA
TTTTTTTTTTAAAAAATTAAAAAAA
TTTTTTTTTTAAAAAATTAAAAAAA
AAAAAATTTTAAAAAATTAAAAAAA
TTTTTTTTTTAAAAAATTAAAAAAA
TTTTTTTTTTAAAAAATTAAAAAAA